5 2 1 4 3 1 1 5
1 2 1 1 2 1 2 1
3 7 7 1 4 7 7 2
1 7 8 1 2 8 7 2
2 4 1 7 7 1 1 1
5 1 7 8 8 7 1 2
1 2 8 8 8 8 2 1
1 2 7 2 1 7 2 2

1 1 2 2 3 5 4 5
2 0 0 0 0 0 0 4
1 0 0 0 0 0 0 1
3 0 0 0 0 0 0 2
5 0 0 0 0 0 0 1
6 0 0 0 0 0 0 1
1 0 0 0 0 0 0 5
2 1 1 2 3 6 5 1

6 1 5 4 1 1 2 1
1 0 0 0 0 0 0 2
3 0 0 0 0 0 0 1
1 0 0 0 0 0 0 1
1 0 0 0 0 0 0 5
1 0 0 0 0 0 0 1
4 0 0 0 0 0 0 5
6 2 2 1 1 4 1 5

2 1 1 2 3 4 5 1
3 0 0 0 0 0 0 2
1 0 0 0 0 0 0 1
2 0 0 0 0 0 0 3
1 0 0 0 0 0 0 5
1 0 0 0 0 0 0 3
5 0 0 0 0 0 0 1
1 1 2 2 6 5 6 5

2 1 1 4 1 3 2 1
5 0 0 0 0 0 0 2
1 0 0 0 0 0 0 4
2 0 0 0 0 0 0 2
3 0 0 0 0 0 0 5
6 0 0 0 0 0 0 4
1 0 0 0 0 0 0 1
2 1 2 3 4 1 1 3

6 1 5 3 1 1 2 3
1 0 0 0 0 0 0 2
3 0 0 0 0 0 0 1
1 0 0 0 0 0 0 2
1 0 0 0 0 0 0 5
1 0 0 0 0 0 0 1
4 0 0 0 0 0 0 5
6 2 2 1 1 4 1 5

1 1 2 2 2 5 6 5
2 0 0 0 0 0 0 3
1 0 0 0 0 0 0 1
3 0 0 0 0 0 0 2
5 0 0 0 0 0 0 1
6 0 0 0 0 0 0 1
1 0 0 0 0 0 0 5
2 1 1 2 3 6 5 1

6 1 2 2 5 3 1 4
5 6 1 2 2 1 3 1
1 3 5 2 2 1 3 3
1 3 5 2 2 1 3 1
2 5 1 1 3 4 5 1
4 3 4 6 7 1 5 3
5 2 3 4 1 1 2 3
1 1 2 4 3 5 1 1  
